000000000111111110
000000000100000310
000000000102120110
000000000102002100
000000000112020100
111111111102010111
144440001102002001
114440000020020001
111110001111111111
111111111000000000