111111001110
144001011311
144001110001
144000002201
144001010201
144111010201
111102012001
000100210201
000102002001
000100110001
000111111111