00001111100000000000000
00001000100000000000000
00001200100000000000000
00111002111000000000000
00100200201000000000000
11101011101000001111111
10001011101111111000441
10200200000000000000441
11111011110131111000441
00001000000111001111111
00001111111100000000000